/* Translation file.
 */
// Uncomment to enable translation!!!
translate = true

// Mandatory color
#F88017 = #F88017
// Optional color
#3B9C9C = #3B9C9C

language = swedish // mysql collation: general, czech, danish, estonian, hungarian, icelandic, latvian, lithuanian, persian, polish, roman, romanian, slovak, slovenian, spanish, swedish, turkish
Welcome! = Välkommen! // welcome mail subject, see mail.txt
Reminder! = Påminnelse! // remind mail subject, see remind.txt
Forgot password? = Glömt lösenord?
Pings = Pingar

// Buttons
Delete = Radera
Search = Sök
Post = Posta
Edit = Editera
Admin = Admin
Logout = Logga&nbsp;ut
Title = Titel
Publish = Publicera
Upload = Ladda&nbsp;upp
Login = Logga&nbsp;in
Create = Skapa
Register = Registrera
Hide = Göm
Show = Visa
Most&nbsp;Read = Mest&nbsp;Lästa
All = Alla
Save = Spara
Profile = Profil
Profile&nbsp;Picture = Profil&nbsp;Bild
Date = Datum
Labels = Etiketter
Label = Etikett

// Fields
Comments = Kommentarer
Comment = Kommentera
eMail = ePost
Nickname = Smeknamn
Password = Lösenord
Confirm = Upprepa
Public = Publikt
Country = Land
Earth = Jorden
Birthday = Födelsedag
First&nbsp;Name = Förnamn
Last&nbsp;Name = Efternamn
Gender = Kön
Female = Flicka
Male = Pojke
Site = Hemsida

Show eMail? = Visa ePost?
Show birthday? = Visa födelsedag?
Show country? = Visa land?
Show first name? = Visa förnamn?
Show last name? = Visa efternamn?
Show twitter? = Visa twitter?

// Pagination
First page = Första sidan
Last page = Sista sidan
Go to page = Gå till sida // followed by the number

// Updates
Reminder sent! = Påminnelse skickad!

// Warnings
Are you sure you want to delete the article? = Är du säker på att du vill ta bort artikeln?
Fill in the mandatory fields! = Fyll i de obligatoriska fälten!

// Benine errors
Check your inbox! = Kolla din inbox!
Wrong password! = Fel lösenord!
User not found! = Användare ej funnen!
Key not found! = Nyckel ej funnen!
That's not an eMail! = Ogiltig ePost!
eMail already in use! = ePost används redan!
Nickname already in use! = Smeknamn används redan!
Passwords don't match! = Lösenorden stämmer inte överens!
User not found! = Användare ej funnen!
State not found! = Status ej funnen!

// Malign errors
You are not authorized! = Du saknar rättigheter!
You are not an administrator! = Du är inte administratör!
You need to login! = Du måste logga in!

// See verify.html
Verify your eMail address by clicking on the link sent in a mail to you. = Verifiera din ePost adress genom att klicka på länken i mailet vi skickat.
Profile saved! = Profilen sparad!

// Months
Jan = Jan
Feb = Feb
Mar = Mar
Apr = Apr
May = Maj
Jun = Jun
Jul = Jul
Aug = Aug
Sep = Sep
Oct = Okt
Nov = Nov
Dec = Dec

AD = Andorra
AE = الإمارات العربية المتحدة
AF = افغانستان
AG = Antigua and Barbuda
AI = Anguilla
AL = Shqipëria
AM = Հայաստան
AN = Nederlandse Antillen
AO = Angola
AQ = Antarctica
AR = Argentina
AS = American Samoa
AT = Österreich
AU = Australia
AW = Aruba
AX = Åland
AZ = Azərbaycan
BA = Босна и Херцеговина
BB = Barbados
BD = বাংলাদেশ
BE = Belgique
BF = Burkina Faso
BG = България
BH = البحرين
BI = Uburundi
BJ = Bénin
BL = Saint Barthélemy
BM = Bermuda
BN = بروني دارالسلام
BO = Bolivia
BR = Brasil
BS = Bahamas
BT = འབྲུག་ཡུལ།
BV = Bouvetøya
BW = Botswana
BY = Беларусь
BZ = Belize
CA = Canada
CC = Cocos (Keeling) Islands
CD = République démocratique du Congo
CF = Ködörösêse tî Bêafrîka
CG = République du Congo
CH = Schweiz
CI = Côte d’Ivoire
CK = Cook Islands
CL = Chile
CM = Cameroun
CN = 中国
CO = Colombia
CR = Costa Rica
CU = Cuba
CV = Cabo Verde
CX = Christmas Island
CY = Κύπρος
CZ = Česko
DE = Deutschland
DJ = جيبوتي
DK = Danmark
DM = Dominica
DO = República Dominicana
DZ = الجزائر
EC = Ecuador
EE = Eesti
EG = مصر
EH = الصحراء الغربية
ER = ኤርትራ
ES = España
ET = ኢትዮጵያ
FI = Suomi
FJ = Fiji
FK = Falkland Islands
FM = Micronesia
FO = Færøerne
FR = France
FX = 
GA = Gabon
GB = United Kingdom
GD = Grenada
GE = საქართველო
GF = Guyane française
GG = Dgèrnésy
GH = Ghana
GI = Gibraltar
GL = Grønland
GM = Gambia
GN = Guinée
GP = Guadeloupe
GQ = Guinea Ecuatorial
GR = Ελλάδα
GS = South Georgia and the South Sandwich Islands
GT = Guatemala
GU = Guam
GW = Guiné-Bissau
GY = Guyana
HK = 香港
HM = Heard and McDonald Islands
HN = Honduras
HR = Hrvatska
HT = Haïti
HU = Magyarország
ID = Indonesia
IE = Ireland
IL = ישראל
IM = Isle of Man
IN = भारत
IO = British Indian Ocean Territory
IQ = العراق
IR = ایران
IS = Ísland
IT = Italia
JE = Jersey
JM = Jamaica
JO = الأردن
JP = 日本
KE = Kenya
KG = Кыргызстан
KH = កម្ពុជា
KI = Kiribati
KM = قُمُرِ
KN = Saint Kitts and Nevis
KP = 朝鮮
KR = 韓國
KW = الكويت
KY = Cayman Islands
KZ = Қазақстан
LA = ປະເທດ​ລາວ
LB = لبنان
LC = Saint Lucia
LI = Liechtenstein
LK = ශ්‍රී ලංකාව
LR = Liberia
LS = Lesotho
LT = Lietuva
LU = Luxembourg
LV = Latvija
LY = ليبيا
MA = المغرب
MC = Monaco
MD = Молдова
ME = Црна Гора
MF = Saint-Martin
MG = Madagascar
MH = Marshall Islands
MK = Македонија
ML = Mali
MM = မ္ရန္‌မာ
MN = Монгол
MO = 澳門
MP = Northern Mariana Islands
MQ = Martinique
MR = موريتانيا
MS = Montserrat
MT = Malta
MU = Mauritius
MV = ދިވެހިރާއްޖެ
MW = Malaŵi
MX = Mēxihco
MY = مليسيا
MZ = Moçambique
NA = Namibia
NC = Nouvelle-Calédonie
NE = Niger
NF = Norfolk Island
NG = Nigeria
NI = Nicaragua
NL = Nederland
NO = Norge
NP = नेपाल
NR = Nauru
NU = Niue
NZ = New Zealand
OM = عمان
PA = Panamá
PE = Perú
PF = Polynésie française
PG = Papua New Guinea
PH = Pilipinas
PK = پاکستان
PL = Polska
PM = Saint-Pierre-et-Miquelon
PN = Pitcairn Islands
PR = Puerto Rico
PS = فلسطين
PT = Portugal
PW = Belau
PY = Paraguay
QA = قطر
RE = Réunion
RO = România
RS = Србија
RU = Россия
RW = Rwanda
SA = السعودية
SB = Solomon Islands
SC = Seychelles
SD = السودان
SE = Sverige
SG = 新加坡
SH = Saint Helena
SI = Slovenija
SJ = Svalbard og Jan Mayen øyene
SK = Slovensko
SL = Sierra Leone
SM = San Marino
SN = Sénégal
SO = الصومال
SR = Suriname
ST = São Tomé e Príncipe
SV = El Salvador
SY = سورية
SZ = eSwatini
TC = Turks and Caicos Islands
TD = تشاد
TF = Terres australes et antarctiques françaises
TG = Togo
TH = ประเทศไทย
TJ = Тоҷикистон
TK = Tokelau
TL = Timór-Leste
TM = Түркменистан
TN = تونس
TO = Tonga
TR = Türkiye
TT = Trinidad and Tobago
TV = Tuvalu
TW = 台湾
TZ = Tanzania
UA = Україна
UG = Uganda
UM = United States Minor Outlying Islands
US = United States of America
UY = Uruguay
UZ = Ўзбекистон
VA = Vaticanum
VC = Saint Vincent and the Grenadines
VE = Venezuela
VG = British Virgin Islands
VI = U.S. Virgin Islands
VN = Việt Nam
VU = Vanuatu
WF = Wallis-et-Futuna
WS = Sāmoa
YE = اليمن
YT = Mayotte
ZA = Republiek van Suid-Afrika
ZM = Zambia
ZW = Zimbabwe